1,1,3,0,2
4,3,4,4,4
2,2,0,3,3
0,4,2,0,0
1,0,2,1,4