1,2,3,1,3
2,1,3,2,4
4,3,1,3,4
1,2,2,3,4
0,1,0,0,1