1,1,4,2,0
1,3,4,4,4
3,2,2,3,0
4,2,0,1,2
3,1,2,2,3