3,1,1,0,0
1,3,2,2,0
1,3,1,3,1
1,4,0,2,1
2,3,0,4,2