2,0,1,0,3
1,0,3,2,1
2,0,2,0,4
0,1,3,1,4
2,4,0,3,1