4,1,4,1,2
2,2,3,3,1
0,3,4,1,2
1,4,0,3,4
0,2,0,3,3