3,4,4,1,0
2,4,4,4,3
1,1,3,1,1
4,4,3,0,3
2,2,4,3,4