3,3,3,0,0
4,0,4,2,1
4,1,3,2,2
1,2,3,4,4
4,2,1,1,3