0,3,4,1,4
2,1,0,0,0
0,1,1,1,2
3,0,4,3,4
4,2,2,1,0