2,l,2,2,1,1
1,l,0,2,4,3
2,l,2,3,1,1
1,l,4,4,1,3
4,l,2,2,0,4