0,3,1,4,3
0,2,0,2,3
4,0,4,2,2
4,3,1,3,0
2,2,3,1,2